NO  ./textures/fish.xpm                 
SO ./textures/unicorn.xpm   
        F               71,11,9
        WE      ./textures/blacksmith.xpm   
EA    ./textures/items.xpm   
C       223,174,12

111111111111111111111
100000000000000010001
100000000000000010001
100000000000000000001
100000000000000000001
100000000000000000001
100000000000000000001
100000000000000000001
100000000000000000001
100000000000000000001
100000000000000000001
100000000000000000001
100000000000000000001
100000000000000000001
100000000000000000001
100000000N00000000001
111111111111111111111