NO ./north_test.xpm                 
SO ./south_test.xpm
F 1,20,50
WE ./west_test.xpm
EA ./east_test.xpm

C 87,122,150

111111111111111111111111111111111
111111101000000000110000000000001111111111111111
111111101011000001110000000000000000000000000001
111111101001000000000000000000001000000000111001
111111101111000001110000000000001000010001111101
100000000011000001110111100011111001011101011101
111111111111110111000000100011111111011101000001
111101111111110111010100100011100000011101011001
110000001101010111000000100011110011111101001001
100000000000000011000000100011111111111111111111
10000000000000001101010000001
11000001110101011111011110N0111
11110111 1110101 101111010001
11111111 1111111 111111111111