        NO ./north_test.xpm                 
SO ./south_test.xpm
F 0,0,0
WE ./west_test.xpm
EA ./east_test.xpm

C 56,56,56     

1111111111111
10000000000N1
1000000000001
1000000000001
1000000000001
1000000000001
1000000000001
1000000000001
1000000000001
1000000000001
1000000000001
1000000000001
1000000000001
1000000000001
1000000000001
1000000000001
1000000000001
1000000000001
1000000000001
1000000000001
1000000000001
1000000000001
1111111111111