NO ./textures/wall_1.xpm                 
SO ./textures/wall_2.xpm
F 0,255,255
WE ./textures/wall_3.xpm
EA ./textures/wall_4.xpm

C 255,255,0     

1111111111110
1000001000001
1000000000001
1000000000001
100000N000001
1000010100001
1000110110001
1000000000001
1000110010001
1000010100001
1000000000001
1111111111111