        NO ./north_test.xpm                 
SO ./south_test.xpm
F 0,0,0
WE ./west_test.xpm
EA ./east_test.xpm


C 56,56,56     

11111
1NNN1
10N01
10001
11111