        NO ./north_test.xpm                 
SO ./south_test.xpm
F 255,0,0
WE ./west_test.xpm
EA ./east_test.xpm

C 0,0,255     

1111111111111
1000000000001
1000000000001
1001111111101
1001000000101
1001011100101
1001010100101
1001011100101
1111111111111
1000000000001
1000000000001
1000100000001
1000100000001
1000100000001
1000000000001
1111111111111
1000000000001
10000000000N1
1111111111111
1000100000001
1000100000001
1000100000001
1000000000001
1000000000001
1111111111111