        NO ./north_test.xpm                 
SO ./south_test.xpm
F 0,0,0
WE ./west_test.xpm
EA ./east_test.xpm

C 56,56,56     

11111111111
10000000001
10000000001
10000000001
10000000001
10000000001
10000000001
10000000001
10000000001
10000000001
1N000000001
11111111111