        NO ./north_test.xpm                 
SO ./south_test.xpm
F 0,255,255
WE ./west_test.xpm
EA ./east_test.xpm

C 255,255,0     

1111111111111
1000000000001
1000000000001
1000000000001
1000000000001
1001111111101
1001000000101
1001011100101
1001010100101
1001011100101
1001000000101
1001111111101
1000000000001
1000000000001
1000000000001
1000100000001
1111111111110
1000000000001
1000000000001
1000000000001
1000000000001
1000010100001
1000110110001
100000N000001
1000110010001
1000010100001
1000000000001
1111111111111